1111111111111111111111111111111111
1E000000B000000C00000C0000000000G1
101G010100100000101001000000010101
101001001010101000100100B000010101
1P0000000C00C0000000000000000000C1
1111111111111111111111111111111111
